1111111111
10000000E1
1C0000!001
10C00000!1
1P0000C001
1111111111