1111111111
1000000!C1
1P1E100001
1111111111