1111111111
1000000!E1
1C0000!0!1
10C00000!1
1P0000C001
1111111111