111111111
10000C001
101010C01
1P10C10E1
111111111
