111111111
100000001
100000001
100PCE001
111111111