111111
1P0001
111011
1C0E01
111111


