11111
1P001
11101
1C0E1
11111
