11111111
1P100101
1010E111
101000C1
11111111