111111
1P00E1
111111
111111
111011
100C01
111111