1111111
0000EP1
100C001
1111111

