11111111111111111111111111111
1P000000000000000000000000001
10100101001001001000000C10101
10100100101011001000000010101
10000000000000000000000000001
11111111111111111111111111111