1111111111111111111111111111111111
1E00000000000000000000000000000001
1010010100100000101001000C00010101
10100100101010100010010000P0010101
1P00000000000000000000000000000001
1111111111111111111111111111111111